#########
#...2...#
#.^.@.^.#
#...@...#
#...*...#
#...@...#
#.^.*.^.#
#...*...#
#########
