.........
....2....
..^.*.^..
....*....
....*....
....@....
..^.*.^..
....*....
.........
