.........
.........
..@.2.@..
....^....
..*^^^*..
....^....
..@.*.@..
.........
.........
